0000000000000000000
WWWWWWWWWWWWWWWWWWW
W111111W111W111111W
W2WW1W1W1W1W1W1WW2W
W1111W111W111W1111W
W1WW1WWW1W1WWW1WW1W
W1W111111W111111W1W
W1W1WW1WWWWW1WW1W1W
W11111111G11111111W
W1WW1W1WW1WW1W1WW1W
W1WW1W11G3G11W1WW1W
W1111W1WWWWW1W1111W
W1WW1W1111111W1WW1W
W11W1W1WWWWW1W1W11W
WW1W11111W11111W1WW
W11W1WWW1W1WWW1W11W
W1WW1W111P111W1WW1W
W1111W1W1W1W1W1111W
W1W1WW1W1W1W1WW1W1W
W2W1111W111W1111W2W
W1WWWW1WWWWW1WWWW1W
W11111111111111111W
WWWWWWWWWWWWWWWWWWW