WWWWWWWWWWWWWWW
W1P11111111111W
W1111111111111W
W1111111111111W
W1111111111111W
W111111W111111W
W1111111111111W
W1111111111111W
W1111111111111W
WWWWWWWWWWWWWWW